[1575  680 1400 2414 2025 6273    0 2529 3325 1353 3542 2494 1099 1339
 1711 1171 2010  921  841 1203 1900  781  990 1019  875 1100 1121    0
 1587 2692 2460 1000 1556 1773 1001 1481 1778    0 1985 2720  934 2384
 1768  602 1322  890    0  907 2697 1005 1106    0 2500 1068 1091 1078
 1091 2582 1464 2554  966 5000 1146 2295 1500  960 1588 1609 1300 1111
 2400 1113 2697 1005 1106    0 2500 1068 1091 1078 1091 2582 1464 2554
  966 5000 1146 2295 1500  960 1588 1609 1300 1111 2400 1113 1667 1290
 4717  987 1120  966 1084 2708 1556 1800 1085 1901 1488 1057 1149 1728
 1058  753 2065 1000 1374 1605 1727 1341 1915 2439 1409 3900 1587 4457
 1550 1939 1901 1545 1566 2055 1097 1046 1384 2200 1103 1671 1569  935
 1198 2154 2580 1439 2220 1796  819 2283 1398 1233 2414 1233 1353 1340
 1730 1000    0 1389 2680 1269 2894 1145 1556    0    0 1571  892 2623
 1449 2697 3125 1274 1563 1603 1152 1318 2120 1933 1235  854 1947 2708
 4176 3021 1560 5000 1107  869 2560 2465    0 1324 2227 2854  978    0
 2163 2333 1099 2343 1562 1589 3447 3605 1544 1000  878 1710 1429  930
 3429 3189 1285 2222 1788    0  733 1100 2011 1055 1315  888 1214 1900
  966 1454 3535 1278 1518 1796 1127 1728 1364 2316 1344 1284 1713  764
 1420 1086 2000 1379 2360  812 1426 1116 1085 4405 1243  991 2303  915
    0 1957 1258 2400  833 2333  935 2400 1692 2271 1032 2162 1140  925
 2818 4412 1574 1220 1045 1830  933 1164 2038 1113 1402 1798 1460 1100
 1829 1480  760 1589 1488 3151 2279 1455 1190 1398 1522    0  937  982
 1175 2043  710    0 4601 1097 1127 2111    0 1575 1324 1140 1167 4727
 1379    0 1500 1544    0 1369 2759 1724  809 1043 2045 1158 1046 1741
 1000 2086 1692 3166  975 1132 1020 1560 1071 1000 6000 1288 1009 3038
 2214 1400  936 1566 3846 3425  812    0 3333 1018 1292 1702 2097    0
 1842    0 1000  827    0 1683 1415 2013 2200  936 1274    0 4487 1080
 2724 3580 2080 1209 3038 2450 3606 2124 1389 1429 1361 1826 1925 1348
 1442 1000 1500 2000  918 1157 1326  958 2202 1015 1275 5000 1388 1595
 1913 2244 2022 1288 1873 2214 2222 1730 1330 3059 1835 1627 1316 2494
 1486 1362 3120 1133 1181 2131 1073 3208 2047  892  986 2141  729 1725
 2824 1438    0 1438 1339 1100 5577 1630 2903 1158 1252 1667  819 1456
  858  913 1153  868 1000 1355 2073 1286  915 1033  828 1384 1960 1925
 2924  884 2708 2644 1260 1488 2457 1788 4637 1238 1500 2273 1268 2400
 1397  951 2500 2270 3083    0  717 4601 2442  887 1264    0 1602 1157
  879 1797    0 1649 1982 2065 2875    0 2857    0 2125 1329 1058  926
 1558 3024 1634 2568  787 1899 1100 1291 1418 1714 3807 1604 1098 1092
 3543 6000 1324 1961 2131    0  822 1215 1000 2647 1998 1556 1280 2214
 1384 1750 2750 2685 2857 1459 1036  534 4455  875 1885  878 2965 1000
 1188 1795 1985 1163 1426 1941 1286 2434 2824 2500 1055 6522 2220 1544
 1732 1715 1138 3731  882    0    0  852 2355 2300 2104  976 1554  920
 2121    0 1388 1455 2667 2246 1960 1562 1136 1721 2244 1707 2091 1364
 2068 2683 1405 2377  988 3151 2302 4048 1977 2800 3792 1528 1064 1696
 1131 1273 1152    0 1237 1967 2889 2309 1000    0    0 1085 2660  927
    0 1000 1719 1500 2300 1250 2429    0 1690 2121 2563 1718 1441 1124
 1115 1071  725 1667 1139 2240 1044  885 2017 1016 1533 2618 1585 1551
 1056 1486 1146 2703 1296 1828 1510 2077 4300 1020 1550  982 1273    0
  973 1036 2152 2015 1650    0    0  796 1550 1569    0    0 1067 2111
 3607 1048 1344    0 1757 1447 2000 1931 1754 3158 2043  921 1742 2375
 1586 2412  921 2017 1500 1643 1702 5153 3088  900 1137 1742  956  999
 1947    0 1722  935  917 1550 1741    0 1242    0 1071 1333 3430 1247
 1490    0 1500  833 1138  741    0 1362  938  903 1609 1084 2446    0
 1893 2656 1167 1719 1757 2222 2778 1548 1374 1536  907 1461 1019 2263
 1743 1433 4338 1160 1281 1529 1615 2200  956    0 1607  707 1508 2455
 2317 3133    0    0 1039 1677 1364 3021 2041 1771 5500 1106 1252 1429
 1250    0 1122 1108 1273  926 2195  955  948 2011 4972 1263 1000  777
 1184    0 1796 1525  914 1602 3810    0 1833 4167 4000 2188    0 3000
 1663 1955 1147 4893 3056    0    0 2333 1789 1652 2700 2024]